########
###>v  #
##o^ #x#
###    #
########
